*******************
*$...............$*
*.*****.******.****
*.*****.******.****
*.................*
*.*****.******.****
*...*.....*.......*
*.................*
*@..*.....*.......*
*******************
